0 1 1 1 1 1 1 1 2
6 7 7 4 4 4 7 7 8
12 13 14 6 7 8 12 13 14
23 19 21 9 10 11 20 19 22
3 4 4 19 19 19 4 4 5 
6 7 7 7 7 7 7 7 8 