00 01 01 01 01 01 01 01 02
03 04 07 07 07 07 07 04 05
06 10 26 27 27 27 28 06 10
37 39 04 04 04 04 04 37 39
03 04 04 04 04 04 04 04 05
03 04 04 04 04 04 07 07 10
06 07 07 07 07 10 14 15 16
11 12 12 12 12 13 17 17 33
34 35 35 35 35 35 35 35 36