00 00 00 00 00 00 00 00 00 00 00 00 00 00 00 00 00 00 00 00 00 00 00 00 00 00 00 00 02 02 02 04 02 02 03 03 03 02 04 02 
00 00 00 00 00 00 00 00 00 00 00 00 00 00 00 00 00 00 00 00 00 00 00 00 00 00 00 00 02 02 02 04 02 02 03 03 03 02 04 02 
02 02 02 00 00 00 00 00 00 00 00 00 00 00 00 00 00 00 00 00 00 00 00 00 00 00 00 00 02 02 02 04 02 02 03 03 03 02 04 02 
02 02 02 02 02 00 00 00 00 00 00 00 00 00 00 00 00 00 00 00 00 00 00 00 00 00 00 02 02 02 02 04 02 03 03 03 03 02 04 02  
02 02 02 02 02 02 00 00 00 00 00 00 00 00 00 00 00 00 00 00 00 00 02 02 02 02 02 02 02 04 04 04 02 03 03 03 03 02 04 04  
02 02 02 02 02 02 02 02 02 02 02 02 02 02 02 02 02 02 02 02 02 02 02 02 04 04 04 04 04 04 02 02 02 03 03 03 03 02 02 04 
04 04 04 04 04 04 04 04 04 04 04 04 04 04 04 04 04 04 04 04 04 04 04 04 04 02 02 02 02 02 02 02 03 03 03 03 03 02 02 04 
04 02 02 02 02 02 02 02 02 02 02 02 02 02 02 02 02 02 02 02 02 02 02 02 02 02 02 02 02 02 03 03 03 03 03 03 02 02 02 04 
04 02 02 02 02 02 02 02 02 02 02 02 02 02 02 02 02 02 02 02 02 02 02 02 02 02 02 02 02 03 03 03 03 03 03 02 02 02 02 04 
04 02 02 02 02 02 02 02 02 02 02 02 02 02 02 02 02 02 02 02 02 02 02 02 03 03 03 03 03 03 03 03 03 03 02 02 02 02 02 04 
04 02 02 02 02 02 02 02 02 02 02 02 02 02 02 02 02 02 02 02 03 03 03 03 03 03 03 03 03 03 03 03 03 02 02 02 02 02 02 04 
04 02 02 02 02 02 03 03 03 02 02 02 02 02 02 02 03 03 03 03 03 03 03 03 03 03 03 03 03 03 03 03 03 02 02 02 02 02 02 04 
04 02 02 02 02 02 03 03 03 02 02 02 02 02 03 03 03 03 03 03 03 03 03 03 03 03 03 03 03 03 03 03 03 02 02 02 02 02 02 04 
04 04 02 02 02 02 03 03 03 03 02 02 02 03 03 03 03 03 03 02 02 02 02 02 02 02 03 03 03 03 03 03 03 02 02 02 02 02 02 04 
02 04 02 02 02 02 02 03 03 03 03 03 03 03 03 03 03 03 02 02 02 02 02 02 02 02 02 03 03 03 03 03 03 02 02 02 02 02 02 04 
02 04 02 02 02 02 02 03 03 03 03 03 03 03 03 03 03 03 02 02 04 04 04 04 04 04 02 03 03 03 03 03 02 02 02 02 02 02 02 04 
02 04 04 02 02 02 02 03 03 03 03 03 03 03 03 03 03 02 02 02 04 02 02 02 02 04 02 02 03 03 03 03 02 02 02 02 02 02 02 04 
02 02 04 02 02 02 02 02 02 02 03 03 03 03 03 03 03 02 02 02 04 02 02 02 02 04 02 02 03 03 03 03 02 02 02 02 02 02 02 04 
02 02 04 02 02 02 02 02 02 02 02 02 02 03 03 03 03 02 02 02 04 02 02 02 02 04 02 02 03 03 03 03 02 02 02 02 02 02 02 04  
02 02 04 04 02 02 02 02 02 02 02 02 02 02 03 03 03 03 02 02 04 02 02 02 02 04 02 02 03 03 03 03 02 02 02 02 02 02 02 04 
02 02 02 04 02 02 02 02 02 02 02 02 02 02 03 03 03 03 02 02 04 04 04 04 04 04 02 02 03 03 03 02 02 02 02 02 02 02 02 04 
02 02 02 04 02 02 02 02 02 02 02 02 02 02 03 03 03 03 02 02 02 02 02 02 02 02 02 03 03 03 03 02 02 02 02 02 02 02 02 04 
02 02 02 04 04 02 02 02 02 02 02 02 02 02 02 03 03 03 03 03 03 03 03 03 03 03 03 03 03 03 03 02 02 02 02 02 02 02 02 04 
02 02 02 02 04 02 02 02 02 02 02 02 02 02 02 03 03 03 03 03 03 03 03 03 03 03 03 03 03 03 03 02 02 02 02 02 02 02 02 04 
02 02 02 02 04 02 02 02 02 02 02 02 02 02 02 03 03 03 03 03 03 03 03 03 03 03 03 03 03 03 02 02 02 02 02 02 02 02 02 04 
02 02 02 02 04 02 02 02 02 02 02 02 02 02 02 03 03 03 03 03 02 02 02 02 02 02 02 02 02 02 02 02 02 02 02 02 02 02 02 04 
02 02 02 02 04 02 02 02 02 02 02 02 02 02 02 03 03 03 03 02 02 02 02 02 02 02 02 02 02 02 02 02 02 02 02 02 02 02 02 04 
02 02 02 04 04 02 02 02 02 02 02 02 02 02 02 03 03 03 03 02 02 02 02 02 02 02 02 02 02 02 02 02 02 02 02 02 02 02 02 04 
02 02 02 04 02 02 02 02 02 02 02 02 02 02 02 03 03 03 02 02 02 02 02 02 02 02 02 02 02 02 02 02 02 02 02 02 02 02 02 04 
02 02 02 04 02 02 02 02 02 02 02 02 02 02 02 03 03 03 02 02 02 02 02 02 02 02 02 02 02 02 02 02 02 02 02 02 02 02 02 04  
02 02 04 04 02 02 02 02 02 02 02 02 02 02 02 03 03 03 02 02 02 02 02 02 02 02 02 02 02 02 02 02 02 02 02 04 04 04 04 04 
02 02 04 02 02 02 02 02 02 02 02 02 02 02 02 03 03 03 02 02 02 02 02 02 02 02 02 02 02 02 02 04 04 04 04 04 00 00 00 00 
02 02 04 02 02 02 02 02 02 02 02 02 02 02 02 02 02 02 02 02 02 02 02 02 02 02 02 04 04 04 04 04 00 00 00 00 00 00 00 00
02 04 04 02 02 02 02 02 02 02 02 02 02 02 02 02 02 02 02 02 02 02 02 02 02 04 04 04 00 00 00 00 00 00 00 00 00 00 00 00 
02 04 02 02 02 02 02 02 02 02 02 02 02 02 02 02 02 02 02 02 02 02 02 02 04 04 00 00 00 00 00 00 00 00 00 00 00 00 00 00 
02 04 02 02 02 02 02 02 02 02 02 02 02 02 02 02 02 02 02 02 02 02 02 04 04 00 00 00 00 00 00 00 00 00 00 00 00 00 00 00 
04 04 02 02 02 02 02 02 02 02 02 04 02 02 02 02 02 02 02 02 02 02 04 04 00 00 00 00 00 00 00 00 00 00 00 00 00 00 00 00 
05 05 05 05 05 05 05 05 05 05 05 04 04 04 04 04 04 04 04 04 04 04 04 00 00 00 00 00 00 00 00 00 00 00 00 00 00 00 00 00 
05 05 05 05 05 05 05 05 05 05 05 05 05 05 05 05 05 05 05 05 05 05 05 00 00 00 00 00 00 00 00 00 00 00 00 00 00 00 00 00 
05 05 05 05 05 05 05 05 05 05 05 05 05 05 05 05 05 05 05 05 05 05 05 00 00 00 00 00 00 00 00 00 00 00 00 00 00 00 00 00














































